Xv, Xv, Xv, Xv, Xv, Qxu, Wo, Wo, Wo, Wo, Wo, Wo, Wo, Wo, Wo, Wo, Wo, Wo, Wo, Ww, Ww, Wo, Xu, Wo, Ww, Ww, Wo, Wo, Wo, Wo, Wo, Wo, Wo, Wo, Wo, Wo, Wo, Qxu, Qxu, Qxu, Qxu, Qxu, Xv
Xv, Xv, Xv, Xv, Xv, Qxu, Wo, Wo, Wo, Wo, Wo, Wo, Wo, Wo, Ww, Wo, Ww, Ww, Ww, Ww, Uh, Xu, Uh, Xu, Ch, Ww, Hh, Wo, Ww, Wo, Wo, Wo, Wo, Wo, Wo, Wo, Wo, Qxu, Qxu, Qxu, Qxu, Xv, Xv
Xv, Xv, Xv, Xv, Xv, Qxu, Wo, Wo, Wo, Wo, Wo, Wo, Wo, Ww, Ww, Ww, Gs^Fp, Ww, Xu, Xu, Gs^Fp, Uu^Tf, Gg, Ch, Uh, Kh, 5 Kh, Gg^Fet, Ww, Ww, Ww, Ww, Ww, Wo, Ww, Wo, Wo, Qxu, Qxu, Qxu, Qxu, Qxu, Xv
Xv, Xv, Xv, Xv, Xv, Qxu, Wo, Wo, Wo, Wo, Wo, Wo, Ww, Ww, Hh, Gs, Gs^Efm, Gg, Gg, Uh, Gg, Gg^Efm, Wo, Gg, Gg, Gs^Efm, Gs, Gg, Gg, Gs^Fp, Hh, Mm, Gs^Fms, Ww, Ww, Wo, Wo, Qxu, Qxu, Qxu, Qxu, Xv, Xv
Xv, Xv, Xv, Xv, Xv, Qxu, Wo, Wo, Wo, Wo, Ww, Wo, Ww, Mm, Gs^Fms, Gg^Ve, Gg, Gg, Wwf, Wwf, Wwf, Wwf, Wwf, Wwf, Wwf, Gg, Gg, Gg, Gg, Gg, Gg, Wwf, Chw, Hh, Gs^Fp, Ww, Wo, Qxu, Qxu, Qxu, Qxu, Xv, Xv
Xv, Xv, Xv, Xv, Xv, Qxu, Wo, Wo, Wo, Wo, Ww, Ww, Gg, Wwf, Wwf, Wwf, Wwf, Wwf, Gs, Gs^Fp, Xu, Uh, Xu, Gs^Fp, Xu, Wwf, Wwf, Gg, Wwf, Wwf, Wwf, Gg, Rr, Rr, Wwf, Ww, Wo, Qxu, Qxu, Qxu, Xv, Xv, Xv
Xv, Xv, Xv, Gg, Xv, Qxu, Wo, Wo, Wo, Ww, Ww, Gs^Fp, Re, Ch, 4 Kh, Chw, Gg, Gg, Re, Xuc, Uh, Xu, Ur, Xu, Xu, Re^Tf, Xu, Xuc, Wwf, Gg, Gg, Hh, Hh, Wwf, Ww, Ww, Xu, Qxu, Xv, Xv, Xv, Xv, Xv
Xv, Xv, Gg, Gg^Br|, Xv, Qxu, Wo, Wo, Wo, Wo, Xuc, Xuc, Hh, Mm, Gg, Chw, Re, Gd^Vud, Xuc, Xuc, Qxu, Gs^Fp, Uu, Ur, Gs^Fp, Xu, Gll, Gg, Wwf, Gg, Gg, Gg^Ve, Gs^Fet, Wwf, Gs^Fp, Ww, Xu, Qxu, Xv, Xv, Xv, Xv, Xv
Xv, Gg, Gg, Gg^Br|, Gg^Br\, Qxu, Wo, Wo, Ww, Ww, Xuc, Gg, Wwf, Gg^Fet, Wwf, Wwf, Xu, Uu, Xu, Wwt, Wwt, Wwf, Wwf, Uh, Xu, Gll, Gg, Gg^Ve, Gg, Wwf, Gg, Gs, Xu, Wwf, Wwf, Xu, Xu, Qxu, Xv, Xv, Gg, Xv, Xv
Xv, Gg, Gg, Xv, Xv, Gg^Br\, Gg, Wo, Ww, Ww, Gg, Wwf, Gg, Wwf, Xu, Xu, Gg, Xu, Xuc, Gg, Xuc, Xuc, Ww, Ww, Gg, Xu, Gg, Gg, Ww, Gg, Gg, Gg, Xu, Xu, Uh, Xu, Xu, Qxu, Xv, Gg, Xv, Gg, Xv
Cf, Gg, Xuc, Xv, Xv, Qxu, Ww, Gg, Gg, Gg, Gg, Gs^Fds, Gg, Re, Gs^Efm, Gg, Gg^Vc, Gg, Gs^Fms, Xuc, Ww, Ww, Ww, Ww, Ww, Gg, Wwf, Wwf, Gg, Ww, Gg, Gg, Re, Gs^Fp, Re, Xu, Xu, Xv, Xv, Xv, Xv, Gg, Xv
Cf, Cf, Xuc, Xv, Xv, Qxu, Ww, Ww, Gg, Gg, Gg, Gg, Re, Re, Mm, Gs^Fp, Gg, Gs, Ww, Ww, Ww, Ww, Ww, Ww, Ww, Wwf, Kh, Gs^Fms, Gg^Efm, Gg, Gg, Gg, Hh, Re, Gg, Xu, Xu, Xv, Gg, Gg, Gg, Gg, Xv
Xuc, Xuc, Gg, Xv, Xv, Qxu, Ww, Ww, Gg^Efm, Gg, Gg, Gg, Gs, Gs, Gs, Hh, Gg, Gs^Fp, Ww, Ww, Wwf, Ww, Mm, Ww, Gs, Sm^Vhs, 2 Kh, Gs, Hh, Gs^Fds, Gg, Mm, Gg, Gg, Ww, Gg, Gg, Cte, Gg, Gg, Gg, Gg, Xv
Xv, Gg, Xv, Gg, Xv, Qxu, Ww, Gg, Gg, Re, Gg, Gg, Gg, Gg, Gg, Gg, Hh, Ww, Wwf, Wwf, Gg, Uu^Tf, Gg, Gs^Fp, Chw, Chw, Wwf, Gg, Gg, Gg, Wwf, Gg, Wwf, Gs^Fp, Ww, Ww, Ww, Gg, Xv, Gg, Gg, Gg, Xv
Xv, Gg, Xv, Xv, Gg, Gg, Ww, Wwf, Wwf, Wwf, Wwf, Gg, Gg, Wwf, Wwf, Gg, Wwf, Wwf, Chw, Gg, Gg, Cte, Gg, Gg, Wwf, Wwf, Gs^Fp, Wwf, Wwf, Wwf, Gg, Wwf, Gg, Wwf, Ww, Wo, Wo, Qxu, Xv, Gg, Gg, Gg, Xv
Xv, Gg, Gg, Gg, Gg, Cte, Gs^Fds, Gs^Fms, Hh, Gg, Gg, Wwf, Wwf, Wwf, Gg, Wwf, 1 Kh, Chw, Gs, Gs^Fp, Mm, Uu^Tf, Wwf, Wwf, Ww, Ww, Gg, Gg, Hh, Gg, Gg, Gg, Gg, Gg, Gg, Ww, Xu, Qxu, Xv, Xv, Xv, Gg, Xuc
Xv, Gg, Gg, Gg, Xv, Qxu, Re, Re, Re, Gg, Re, Gg, Gs^Fp, Mm, Hh, Gg, Kh, Sm^Vhs, Ww, Ww, Ww, Ww, Xuc, Ww, Ww, Ww, Gg, Gg, Gg, Mm, Gg, Gg, Gg, Re, Gg, Xu, Xu, Qxu, Xv, Xv, Xuc, Xuc, Cte
Xv, Gg, Gg, Gg, Xv, Qxu, Xu, Xu, Xu, Xu, Re, Re, Re, Re, Gg, Gg, Wwf, Wwf, Ww, Ww, Ww, Ww, Ww, Xuc, Xuc, Xuc, Xuc, Gg^Ve, Gs^Fds, Gg, Gg, Gg, Gg, Re, Xu, Xu, Xu, Qxu, Xv, Xv, Xuc, Cte, Cte
Xv, Gg, Gg, Gg, Xv, Qxu, Xu, Xu, Uu^Tf, Uu^Tf, Uh, Gg, Gg, Gg, Wwf, Wwf, Xu, Ww, Hh, Gs^Fp, Ww, Ww, Gs^Fp, Hh, Wwr, Wwr, Ds, Xuc, Xu, Re, Re, Gg, Re, Re, Gg, Gg, Gg^Br\, Qxu, Xv, Xv, Gg, Gg, Xv
Xv, Gg, Xv, Xv, Xv, Qxu, Xu, Xu, Chr, Wwf, Xu, Xu, Wwf, Gs, Gs, Xu, Xu, Xu, Xu, Cte, Wo, Gg, Xu, Cte, Xu, Xu, Xu, Xu, Gs^Fp, Xuc, Re, Re, Gg, Gg, Gs^Fp, Xu, Xu, Gg^Br\, Gg^Br\, Xv, Gg, Gg, Xv
Xv, Xv, Xv, Xv, Xv, Qxu, Xu, Xu, Chr, Wwf, Wwf, Ww, Gg, Gg, Re, Re, Uu^Vu, Ur, Uu^Tf, Xuc, Wo, Xu, Xu, Uu^Tf, Xuc, Xu, Uu^Vu, Re, Re, Gg, Gg, Gg, Uu^Vud, Uu^Tf, Cte, Xu, Xu, Qxu, Xv, Gg^Br|, Gg, Gg, Xv
Xv, Xv, Xv, Xv, Xv, Qxu, Wwf, Wwf, Wwf, Wwf, Gs^Fp, Gg^Vc, Re, Re, Xu, Ur, Ur, Uh, Uh, Wwf, Wwf, Xu, Wwf, Xuc, Uh, Uh, Ur, Ur, Xu, Re, Gg, Gg, Xuc, Ur, Cte, Xu, Xu, Qxu, Xv, Gg^Br|, Xv, Xv, Xv
Xv, Xv, Xv, Xv, Xv, Qxu, Xu, Xu, Xu, Xu, Gg, Gg^Efm, Mm, Re, Re, Xu, Re, Xu, Wwf, Wwf, Gg^Efm, Wwf, Gg, Wwf, Wwf, Xu, Re, Xu, Re, Re, 3 Kf, Gg, Xu, Xu, Xu, Xu, Xu, Qxu, Xv, Gg, Xv, Xv, Xv
Xv, Xv, Xv, Xv, Xv, Qxu, Xu, Xu, Xu, Xu, Xu, Hh, Gs^Fp, Gg, Gg, Re, Gg, Gg, Wwf, Mm, Hh^Fds, Wwf, Gg^Tf, Hh, Gg, Wwf, Gg, Re, Gg, Cf, Cf, Cf, Xu, Xu, Xu, Xu, Xu, Qxu, Xv, Xv, Xv, Xv, Xv
Xv, Xv, Xv, Xv, Xv, Qxu, Xu, Xu, Xu, Xu, Xu, Xu, Re^Tf, Gg, Gs^Fms, Gg^Ve, Gg, Wwf, Gg^Tf, Gg, Gg, Wwf, Wwf, Gg^Fms, Gg, Wwf, Gg, Gg^Ve, Gs^Fds, Re, Re^Tf, Xur, Xu, Xu, Xu, Xu, Xu, Qxu, Xv, Xv, Xv, Xv, Xv
Xv, Xv, Xv, Xv, Xv, Qxu, Xu, Xu, Xu, Xu, Xu, Xu, Ur, Xu, Xu, Ch, 6 Kh, Wwf, Gg, Hh, Gg, Gg^Fp, Wwf, Gg, Hh, Wwf, Wwf, Gg^Efm, Xu, Xu, Ur, Xu, Xu, Xu, Xu, Xu, Xu, Qxu, Xv, Xv, Xv, Xv, Xv
Xv, Xv, Xv, Xv, Xv, Qxu, Xu, Xu, Xu, Xu, Xu, Xu, Ur, Xu, Rrc, Xu, Wwf, Kh, Ch, Gg, Xu, Gg, Wwf, Mm, Gg^Efm, Gg, Wwf, Xu, Xu, Ur, Xu, Xu, Xu, Xu, Xu, Xu, Xu, Qxu, Xv, Xv, Xv, Xv, Xv
Xv, Xv, Xv, Xv, Xv, Qxu, Xu, Xu, Xu, Xu, Xu, Xu, Xu, Rrc, Wwf, Chw, Wwf, Rrc, Ur, Xu, Xu, Wwf, Xu, Xu, Ur, Chw, Rrc, Wwf, Wwf, Chw, Wwf, Xu, Xu, Xu, Xu, Xu, Xu, Qxu, Xv, Xv, Xv, Xv, Xv
Xv, Xv, Xv, Xv, Xv, Qxu, Xu, Xu, Xu, Xu, Xu, Xu, Xu, Wwf, Xu, Xu, Rrc, Rrc, Wwf, Uh, Wwf, Wwf, Wwf, Uu^Tf, Wwf, Rrc, Rrc, Rrc, Rrc, Wwf, Xu, Xu, Xu, Xu, Xu, Xu, Xu, Qxu, Xv, Xv, Xv, Xv, Xv
Xv, Xv, Xv, Xv, Xv, Qxu, Xu, Xu, Xu, Xu, Xu, Xu, Xu, Xu, Xu, Xu, Xu, Xu, Wo, Wwf, Ur, Chw, Wwf, Wwf, Wo, Xu, Xu, Xu, Xu, Xu, Xu, Xu, Xu, Xu, Xu, Xu, Xu, Qxu, Xv, Xv, Xv, Xv, Xv
Xv, Xv, Xv, Xv, Qxu, Qxu, Xu, Xu, Xu, Xu, Xu, Xu, Xu, Xu, Xu, Xu, Xu, Xu, Xu, Xu, Xu, Ur, Wo, Uh, Xu, Xu, Xu, Xu, Xu, Xu, Xu, Xu, Xu, Xu, Xu, Xu, Xu, Qxu, Xv, Xv, Xv, Xv, Xv
^Vu, Xv, Qxu, Qxu, Qxu, Qxu, Xu, Xu, Xu, Xu, Xu, Xu, Xu, Xu, Xu, Xu, Xu, Xu, Xu, Xu, Xu, Wo, Wo, Xu, Xu, Xu, Xu, Xu, Xu, Xu, Xu, Xu, Xu, Xu, Xu, Xu, Xu, Qxu, Qxu, Xv, Xv, Xv, ^Vu
