Ai, Ai, Ai, Ai, Ai, Ai, Ai, Ai, Ai, Ai, Ai, Ai, Ai, Ai, Ai, Ai, Ai, Ai, Ai, Ai, Ai, Ai, Ai, Ai, Ai, Ai, Ai, Ai, Ai, Ai, Ai, Ai, Ai, Ai, Ai, Ai, Ai, Ai, Ai, Ai, Ai, Ai, Ai, Ai, Ai, Ai, Ai, Ai, Ai, Ai, Ai, Ai, Ai, Ai, Ai, Ai, Ai, Ai, Ai, Ai, Ai, Ai, Ai, Ai, Ai
Ai, Ai, Ai, Ai, Ai, Ai, Ai, Ai, Ai, Ai, Ai, Ai, Ai, Ai, Ai, Ai, Ai, Ai, Ai, Ai, Ai, Ai, Ai, Ai, Ai, Ai, Ai, Ai, Ai, Ai, Ai, Ai, Ai, Ai, Ai, Ai, Ai, Ai, Ai, Ai, Ai, Ai, Ai, Ai, Ai, Ai, Ai, Ai, Ai, Ai, Ai, Ai, Ai, Ai, Ai, Ai, Ai, Ai, Ai, Ai, Ai, Ai, Ai, Ai, Ai
Ai, Ai, Ai, Ai, Ai, Ai, Ai, Ai, Ai, Ai, Ai, Ai, Ai, Ai, Ai, Ai, Ai, Ai, Ai, Ai, Ai, Ai, Ai, Ai, Ai, Ai, Ai, Ai, Ai, Ai, Ai, Ai, Ai, Ai, Ai, Ai, Ai, Ai, Ai, Ai, Ai, Ai, Ai, Ai, Ai, Ai, Ai, Ai, Ai, Ai, Ai, Ai, Ai, Ai, Ai, Ai, Ai, Ai, Ai, Ai, Ai, Ai, Ai, Ai, Ai
Ai, Ai, Ai, Ai, Ai, Ai, Ai, Ai, Ai, Ai, Ai, Ai, Ai, Ai, Ai, Ai, Ai, Ai, Ai, Ai, Ai, Ai, Ai, Ai, Ai, Ai, Ai, Ai, Ai, Ai, Xu, Ai, Ai, Ai, Xu, Ai, Ai, Ai, Ai, Ai, Ai, Ai, Ai, Ai, Ai, Ai, Ai, Ai, Ai, Ai, Ai, Ai, Ai, Ai, Ai, Ai, Ai, Ai, Ai, Ai, Ai, Ai, Ai, Ai, Ai
Ai, Ai, Ai, Ai, Ai, Ai, Ai, Ai, Ai, Ai, Ai, Ai, Ai, Ai, Ai, Ai, Ai, Ai, Ai, Ai, Ai, Ai, Ai, Ai, Ai, Ai, Ai, Ai, Xu, Xu, Aa, Xu, Xu, Xu, Aa, Xu, Xu, Ai, Ai, Ai, Ai, Ai, Ai, Ai, Ai, Ai, Ai, Ai, Ai, Ai, Ai, Ai, Ai, Ai, Ai, Ai, Ai, Ai, Ai, Ai, Ai, Ai, Ai, Ai, Ai
Ai, Ai, Ai, Ai, Ai, Ai, Ai, Ai, Ai, Ai, Ai, Ai, Ai, Ai, Ai, Ai, Ai, Ai, Ai, Ai, Ai, Ai, Ai, Ai, Ai, Ai, Ai, Ai, Xu, Aa, Xu, Aa, Aa, Aa, Xu, Aa, Xu, Ai, Ai, Ai, Ai, Ai, Ai, Ai, Ai, Ai, Ai, Ai, Ai, Ai, Ai, Ai, Ai, Ai, Ai, Ai, Ai, Ai, Ai, Ai, Ai, Ai, Ai, Ai, Ai
Ai, Ai, Ai, Ai, Ai, Ai, Ai, Ai, Ai, Ai, Ai, Ai, Ai, Ai, Ai, Ai, Ai, Ai, Ai, Ai, Ai, Ai, Ai, Ai, Xu, Xu, Xu, Ai, Xu, Aa, Aa, Aa, Xu, Aa, Aa, Aa, Xu, Ai, Xu, Xu, Xu, Ai, Ai, Ai, Ai, Ai, Ai, Ai, Ai, Ai, Ai, Ai, Ai, Ai, Ai, Ai, Ai, Ai, Ai, Ai, Ai, Ai, Ai, Ai, Ai
Ai, Ai, Ai, Ai, Ai, Ai, Ai, Ai, Ai, Ai, Ai, Ai, Ai, Ai, Ai, Ai, Ai, Ai, Ai, Ai, Ai, Ai, Ai, Xu, Uu, Uu, Uu, Xu, Ds, Xu, Xu, Xu, Ds, Xu, Xu, Xu, Ds, Xu, Uu, Uu, Uu, Xu, Ai, Ai, Ai, Ai, Ai, Ai, Ai, Ai, Ai, Ai, Ai, Ai, Ai, Ai, Ai, Ai, Ai, Ai, Ai, Ai, Ai, Ai, Ai
Ai, Ai, Ai, Ai, Ai, Ai, Ai, Ai, Ai, Ai, Ai, Ai, Ai, Ai, Ai, Ai, Ai, Ai, Ai, Ai, Xu, Ai, Ai, Xu, Uu, Xu, Uu, Xu, Ds, Ds, Xu, Ds, Ds, Ds, Xu, Ds, Ds, Xu, Uu, Xu, Uu, Xu, Ai, Ai, Xu, Ai, Ai, Ai, Ai, Ai, Ai, Ai, Ai, Ai, Ai, Ai, Ai, Ai, Ai, Ai, Ai, Ai, Ai, Ai, Ai
Ai, Ai, Ai, Ai, Ai, Ai, Ai, Ai, Ai, Ai, Ai, Ai, Ai, Ai, Ai, Ai, Ai, Ai, Xu, Xu, Wo, Xu, Xu, Xu, Xu, Uu, Xu, Xu, Xu, Xu, Ql, Xu, Xu, Xu, Ql, Xu, Xu, Xu, Xu, Uu, Xu, Xu, Xu, Xu, Wo, Xu, Xu, Ai, Ai, Ai, Ai, Ai, Ai, Ai, Ai, Ai, Ai, Ai, Ai, Ai, Ai, Ai, Ai, Ai, Ai
Ai, Ai, Ai, Ai, Ai, Ai, Ai, Ai, Ai, Ai, Ai, Ai, Ai, Ai, Ai, Ai, Ai, Ai, Xu, Wo, Xu, Wo, Xu, Rd, Rd, Xu, Dd, Dd, Xu, Ql, Ql, Ql, Xu, Ql, Ql, Ql, Xu, Dd, Dd, Xu, Rd, Rd, Xu, Wo, Xu, Wo, Xu, Ai, Ai, Ai, Ai, Ai, Ai, Ai, Ai, Ai, Ai, Ai, Ai, Ai, Ai, Ai, Ai, Ai, Ai
Ai, Ai, Ai, Ai, Ai, Ai, Ai, Ai, Ai, Ai, Ai, Ai, Ai, Ai, Xu, Xu, Xu, Ai, Xu, Wo, Wo, Wo, Xu, Rd, Xu, Xu, Xu, Xu, Xu, Ql, Ql, Ql, Xu, Ql, Ql, Ql, Xu, Xu, Xu, Xu, Xu, Rd, Xu, Wo, Wo, Wo, Xu, Ai, Xu, Xu, Xu, Ai, Ai, Ai, Ai, Ai, Ai, Ai, Ai, Ai, Ai, Ai, Ai, Ai, Ai
Ai, Ai, Ai, Ai, Ai, Ai, Ai, Ai, Ai, Ai, Ai, Ai, Ai, Xu, Ww, Ww, Ww, Xu, Wo, Xu, Xu, Xu, Ww, Xu, Uu, Qxu, Ww, Ww, Uh, Xu, Xu, Xu, Uu, Xu, Xu, Xu, Uh, Ww, Ww, Qxu, Uu, Xu, Ww, Xu, Xu, Xu, Wo, Xu, Ww, Ww, Ww, Xu, Ai, Ai, Ai, Ai, Ai, Ai, Ai, Ai, Ai, Ai, Ai, Ai, Ai
Ai, Ai, Ai, Ai, Ai, Ai, Ai, Ai, Ai, Ai, Xu, Ai, Ai, Xu, Ww, Xu, Ww, Xu, Wo, Wo, Xu, Ww, Ww, Xu, Qxu, Rb, Ww, Xu, Cud, Kud, Xue, Uu, Uu, Uu, Xu, Kud, Cud, Xu, Ww, Rb, Qxu, Xu, Ww, Ww, Xu, Wo, Wo, Xu, Ww, Xu, Ww, Xu, Ai, Ai, Xu, Ai, Ai, Ai, Ai, Ai, Ai, Ai, Ai, Ai, Ai
Ai, Ai, Ai, Ai, Ai, Ai, Ai, Ai, Xu, Xu, Ai, Xu, Xu, Xu, Xu, Ww, Xu, Xu, Xu, Xu, Qxu, Xu, Xu, Xu, Xu, Qxu^Bs|, Rb, Wwf, Xu, Rr, Xue, Xu, Xu, Xu, Xue, Rr, Xu, Wwf, Rb, Qxu^Bs|, Xu, Xu, Xu, Xu, Qxu, Xu, Xu, Xu, Xu, Ww, Xu, Xu, Xu, Xu, Ai, Xu, Xu, Ai, Ai, Ai, Ai, Ai, Ai, Ai, Ai
Ai, Ai, Ai, Ai, Ai, Ai, Ai, Ai, Xu, Ai, Xu, Ai, Xu, Kud, Cud, Xu, Cud, Xu, Gd, Uu, Uu^Vu, Qxu, Xu, Ql, Ql, Xu, Gd^Fdf, Wwf, Rr, Rr, Gd, Xu, Ql, Xu, Gd, Rr, Rr, Wwf, Gd^Fdf, Xu, Ql, Ql, Xu, Qxu, Uu^Vu, Uu, Gd, Xu, Cud, Xu, Cud, Kud, Xu, Ai, Xu, Ai, Xu, Ai, Ai, Ai, Ai, Ai, Ai, Ai, Ai
Ai, Ai, Ai, Ai, Xu, Xu, Xu, Ai, Xu, Ai, Ai, Ai, Xu, Cud, Rr, Cud, Gd, Gd, Rr, Rr, Rr, Uu, Xu, Ql, Xu, Xu, Xu, Hhd, Rr, Xu, Gd^Fdf, Xu, Xu, Xu, Gd^Fdf, Xu, Rr, Hhd, Xu, Xu, Xu, Ql, Xu, Uu, Rr, Rr, Rr, Gd, Gd, Cud, Rr, Cud, Xu, Ai, Ai, Ai, Xu, Ai, Xu, Xu, Xu, Ai, Ai, Ai, Ai
Ai, Ai, Ai, Xu, Aa, Aa, Aa, Xu, Wo, Xu, Xu, Xu, Wwf, Wwf, Gd, Rr, Rr, Rr, Xu, Xu, Xu, Rr, Rr, Xu, Gd, Hhd, Gd, Xu, Rr, Gs, Ds, Ds, Wwt, Ds, Ds, Gs, Rr, Xu, Gd, Hhd, Gd, Xu, Rr, Rr, Xu, Xu, Xu, Rr, Rr, Rr, Gd, Wwf, Wwf, Xu, Xu, Xu, Wo, Xu, Aa, Aa, Aa, Xu, Ai, Ai, Ai
Ai, Ai, Ai, Xu, Aa, Xu, Aa, Xu, Wo, Wo, Xu, Xu, Ww, Ww, Gd, Gd, Rr, Xu, Ql, Qxu, Xu, Gd^Fdf, Gd^Fdf, Rr, Rr, Gd, Cud, Xu, Rr, Ds, Wwt, Wwt, Wwt, Wwt, Wwt, Ds, Rr, Xu, Cud, Gd, Rr, Rp, Gd^Fdf, Gd^Fdf, Xu, Qxu, Ql, Xu, Rr, Gd, Gd, Ww, Ww, Xu, Xu, Wo, Wo, Xu, Aa, Xu, Aa, Xu, Ai, Ai, Ai
Ai, Ai, Ai, Xu, Xu, Aa, Xu, Xu, Xu, Xu, Ql, Xu, Xu, Ww, Gs, Gd, Rr, Xu, Xu, Mv, Rb, Xu, Xu, Xu, Xu, Rr, Rr, Rr, Ww, Wwf, Ds, Wwt, Wwt, Wwt, Ds, Wwf, Ww, Rr, Rr, Rr, Xu, Xu, Xu, Xu, Rb, Mv, Xu, Xu, Rr, Gd, Gs, Ww, Xu, Xu, Ql, Xu, Xu, Xu, Xu, Aa, Xu, Xu, Ai, Ai, Ai
Ai, Ai, Ai, Ai, Ai, Xu, Ww, Ww, Xu, Ql, Ql, Ql, Xu, Uu^Vu, Gd^Fdf, Gs, Rr, Uh, Xu, Rb, Gd, Gd, Gd, Ds^Esd, Wwt, Rr, Gll^Fp, Ww, Wwt, Hhd, Gd^Fmw, Ds, Wwt, Ds, Gd^Fmw, Hhd, Wwt, Ww, Gll^Fp, Rr, Wwt, Dd^Edp, Gd, Gd, Gd, Rb, Xu, Uh, Rr, Gs, Gd^Fdf, Uu^Vu, Xu, Ql, Ql, Ql, Xu, Ww, Ww, Xu, Ai, Ai, Ai, Ai, Ai
Ai, Ai, Ai, Ai, Xu, Xu, Xu, Ww, Xu, Ql, Ql, Ql, Xu, Hh, Xu, Gs, Rr, Uh, Xu, Gs^Efm, Gs, Gs, Gg^Ve, Ds, Wwt, Rp, Wwf, Wwf, Ww, Gll^Wm, Md, Ds, Wwt, Ds, Md, Gll, Ww, Wwf, Wwf, Rr, Wwt, Ds^Esd, Gg^Ve, Gs^Efm, Gs, Gd, Xu, Uh, Rr, Gs, Xu, Hh, Xu, Ql, Ql, Ql, Xu, Ww, Xu, Xu, Xu, Ai, Ai, Ai, Ai
Ai, Ai, Ai, Xu, Ds, Ds, Ds, Xu, Ai, Xu, Xu, Xu, Aa, Xu, Gd^Fdf, Gs, Rr, Xu, Hh, Gg, Gd, Gs, Ds, Dd, Md^Xm, Rr, Gll^Fp, Gll^Fp, Wwf, Wwf, Ww, Wwt, Wwt, Wwt, Ww, Wwf, Wwf, Gll^Fp, Gll^Fp, Rr, Md^Xm, Ds, Ds, Gd, Gs, Gg, Hh, Xu, Rr, Gs, Gd^Fdf, Xu, Aa, Xu, Xu, Xu, Ai, Xu, Ds, Ds, Ds, Xu, Ai, Ai, Ai
Ai, Ai, Ai, Xu, Ds, Xu, Ds, Xu, Ai, Ai, Xu, Aa, Aa, Xu, Gs, Gs, Rr, Xu, Rp, Mm^Xm, Dd^Do, Gd, 5 Khw, Wwf, Ds^Esd, Rr, Rr, Gll, Sm, Ww, Gll^Gvs, Ds, Wwt, Ds, Gll^Gvs, Ww, Sm, Gll, Rr, Rr, Ds, Wwf, 6 Khw, Gd, Dd^Do, Mm^Xm, Rp, Xu, Rr, Gs, Gs, Xu, Aa, Aa, Xu, Ai, Ai, Xu, Ds, Xu, Ds, Xu, Ai, Ai, Ai
Ai, Ai, Ai, Xu, Xu, Ds, Xu, Xu, Xu, Xu, Uu^Tf, Xu, Xu, Xu, Xu, Cud, Gs, Rp, Gll^Fp, Rr, Rr, Chw, Chw, Ww^Ewf, Dd, Gs^Fms, Md, Rr, Rr, Gd^Fmw, Gd^Gvs, Ds, Wwt, Ds, Gd^Gvs, Gd^Fmw, Rr, Rr, Md, Gs^Fms, Dd, Ww^Ewf, Chw, Chw, Rr, Rr, Gll^Fp, Rp, Gs, Cud, Xu, Xu, Xu, Xu, Uu^Tf, Xu, Xu, Xu, Xu, Ds, Xu, Xu, Ai, Ai, Ai
Ai, Ai, Ai, Ai, Ai, Xu, Dd, Dd, Xu, Uu^Tf, Uu^Vu, Uu^Tf, Xu, Ql, Ql, Xu, Md, Gs, Gd^Fmw, Gll^Fp, Rr, Rr, Ww^Bsb\, Ww, Wwt, Dd, Gd^Fmw, Hhd^Fdw, Rr, Gd^Gvs, Dd^Do, Ds, Wwt, Ds, Dd^Do, Gd^Gvs, Rr, Hhd^Fmf, Gd^Fmw, Dd^Dc, Wwt, Ww, Ww^Bsb/, Rrc, Rr, Gll^Fp, Gd^Fmw, Gs^Efm, Md, Xu, Ql, Ql, Xu, Uu^Tf, Uu^Vu, Uu^Tf, Xu, Dd, Dd, Xu, Ai, Ai, Ai, Ai, Ai
Ai, Ai, Ai, Ai, Xu, Xu, Xu, Dd, Xu, Uu^Tf, Uu^Tf, Uu^Tf, Rr, Rr, Rr, Hhd, Gd^Fdf, Gd, Rr, Rr, Ww, Wwt, Gd^Fmw, Rrc, Rr, Gd, Rr, Rr, Chw, Chw, Gg^Ve, Ds, Wwf, Ds, Gg^Ve, Chw, Chw, Rr, Rr, Gd, Rr, Rp, Gd^Fmw, Wwt, Ww, Rr, Rr, Gd, Gd^Fdf, Hhd, Rr, Rr, Rr, Uu^Tf, Uu^Tf, Uu^Tf, Xu, Dd, Xu, Xu, Xu, Ai, Ai, Ai, Ai
Ai, Ai, Ai, Xu, Rd, Rd, Rd, Xu, Ql, Xu, Xu, Rr, Xu, Cud, Xu, Rr, Rr, Rr, Ww, Ww, Chw, Ds, Wwf, Hhd, Wwt, Rr, Wwf, Wwt, Wwt, 1 Khw, Wwf, Wwf, Mm^Xm, Wwf, Wwf, 2 Khw, Wwt, Wwt, Wwf, Rr, Wwt, Hhd, Wwf, Ds, Chw, Ww, Ww, Rr, Rr, Rr, Xu, Cud, Xu, Rr, Xu, Xu, Ql, Xu, Rd, Rd, Rd, Xu, Ai, Ai, Ai
Ai, Ai, Ai, Xu, Rd, Xu, Rd, Xu, Ql, Ql, Xu, Xu, Xu, Xu, Xu, Hhd^Fdf, Rr, Dd^Do, Ww, Khw, Chw, Wwf, Wwf, Ww, Wwt, Qxe, Wwf, Wwt, Wwt, Wwt, Wwf, Mm^Xm, Mm^Xm, Mm^Xm, Wwf, Wwt, Wwt, Wwt, Wwf, Qxe, Wwt, Ww, Wwf, Wwf, Chw, Khw, Ww, Dd^Do, Rr, Hhd^Fdf, Xu, Xu, Xu, Xu, Xu, Ql, Ql, Xu, Rd, Xu, Rd, Xu, Ai, Ai, Ai
Ai, Ai, Ai, Xu, Xu, Rd, Xu, Xu, Xu, Xu, Uu^Tf, Rr, Rr, Cud, Rr, Rr, Gd^Fdf, Rr, Rr, Ww, Ww, Ds, Gd^Fmw, Hhd, Rr, Rr, Rr, Wwt, Chw, 3 Khw, Gg^Ve, Wwf, Wwf, Wwf, Gg^Ve, 4 Khw, Chw, Wwt, Rr, Rr, Rr, Hhd, Gd^Fmw, Ds, Ww, Ww, Rr, Rr, Gd^Fdf, Rr, Rr, Cud, Rr, Rr, Uu^Tf, Xu, Xu, Xu, Xu, Rd, Xu, Xu, Ai, Ai, Ai
Ai, Ai, Ai, Ai, Ai, Xu, Dd, Dd, Xu, Uu^Tf, Uu^Vu, Uu^Tf, Xu, Rr, Ql, Hhd, Md, Gd, Gd^Fmw, Rr, Rr, Wwt, Ww^Bsb/, Rp, Wwt, Gd, Gd^Fmw, Rr, Rr, Chw, Dd^Do, Ds, Wwt, Ds, Dd^Do, Chw, Rr, Rr, Gd^Fmw, Gd, Wwt, Rrc, Ww^Bsb\, Wwt, Rr, Rr, Gd^Fmw, Gd, Md, Hhd, Ql, Rr, Xu, Uu^Tf, Uu^Vu, Uu^Tf, Xu, Dd, Dd, Xu, Ai, Ai, Ai, Ai, Ai
Ai, Ai, Ai, Ai, Xu, Xu, Xu, Dd, Xu, Uu^Tf, Uu^Tf, Uu^Tf, Xu, Ql, Xu, Xu, Gs, Gs^Efm, Gll^Fp, Gll^Fp, Rr, Rrc, Chw, Ww, Dd, Dd^Dc, Md, Hhd^Fmf, Rr, Gd^Gvs, Gd^Gvs, Ds, Wwt, Ds, Gd^Gvs, Gd^Gvs, Rr, Hhd^Fdw, Md, Dd, Dd, Ww, Chw, Rr, Rr, Gll^Fp, Gll^Fp, Gs, Gs, Xu, Xu, Ql, Xu, Uu^Tf, Uu^Tf, Uu^Tf, Xu, Dd, Xu, Xu, Xu, Ai, Ai, Ai, Ai
Ai, Ai, Ai, Xu, Ds, Ds, Ds, Xu, Ai, Xu, Xu, Xu, Aa, Xu, Gs, Cud, Rr, Rp, Rp, Rr, Dd^Do, Chw, 7 Khw, Ww^Ewf, Ds, Gs^Fms, Rr, Rr, Sm, Gd^Fmw, Gll^Gvs, Ds, Wwt, Ds, Gll^Gvs, Gd^Fmw, Sm, Rr, Rr, Gs^Fms, Ds^Esd, Ww^Ewf, 8 Khw, Chw, Dd^Do, Rr, Rp, Rp, Rr, Cud, Gs, Xu, Aa, Xu, Xu, Xu, Ai, Xu, Ds, Ds, Ds, Xu, Ai, Ai, Ai
Ai, Ai, Ai, Xu, Ds, Xu, Ds, Xu, Ai, Ai, Xu, Aa, Aa, Xu, Gd^Fdf, Gs, Rr, Xu, Hh, Mm^Xm, Gs, Gd, Ds, Wwf, Md^Xm, Rr, Gll^Fp, Gll, Wwf, Ww, Ww, Ds, Wwt, Ds, Ww, Ww, Wwf, Gll, Gll^Fp, Rr, Md^Xm, Wwf, Ds, Gd, Gd, Mm^Xm, Hh, Xu, Rr, Gs, Gd^Fdf, Xu, Aa, Aa, Xu, Ai, Ai, Xu, Ds, Xu, Ds, Xu, Ai, Ai, Ai
Ai, Ai, Ai, Xu, Xu, Ds, Xu, Xu, Xu, Xu, Ql, Xu, Xu, Xu, Xu, Gs, Rr, Xu, Xu, Gg, Gs, Gd, Gg^Ve, Ds, Wwt, Rr, Wwf, Gll^Fp, Ww, Wwf, Md, Ww, Wwt, Ww, Md, Wwf, Ww, Gll^Fp, Wwf, Rr, Wwt, Dd, Gg^Ve, Gs, Gs, Gg, Xu, Xu, Rr, Gs, Xu, Xu, Xu, Xu, Ql, Xu, Xu, Xu, Xu, Ds, Xu, Xu, Ai, Ai, Ai
Ai, Ai, Ai, Ai, Ai, Xu, Ww, Ww, Xu, Ql, Ql, Ql, Xu, Hh, Gd^Fdf, Gs, Rr, Uh, Xu, Gd, Gd, Gs^Efm, Gd, Ds^Esd, Wwt, Rr, Gll^Fp, Wwf, Wwt, Gll, Gd^Fmw, Ds, Wwt, Ds, Gd^Fmw, Gll^Wm, Wwt, Wwf, Gll^Fp, Rp, Wwt, Ds, Gd, Gs, Gd, Gs^Efm, Xu, Uh, Rr, Gs, Gd^Fdf, Hh, Xu, Ql, Ql, Ql, Xu, Ww, Ww, Xu, Ai, Ai, Ai, Ai, Ai
Ai, Ai, Ai, Ai, Xu, Xu, Xu, Ww, Xu, Ql, Ql, Ql, Xu, Uu^Vu, Gs, Gs, Rr, Uh, Xu, Rb, Rb, Gd, Xu, Dd^Edp, Xu, Rr, Rr, Ww, Ww, Hhd, Ds, Ds, Wwt, Ds, Ds, Hhd, Ww, Ww, Rr, Rr, Xu, Ds^Esd, Xu, Gd, Rb, Rb, Xu, Uh, Rr, Gs, Gs, Uu^Vu, Xu, Ql, Ql, Ql, Xu, Ww, Xu, Xu, Xu, Ai, Ai, Ai, Ai
Ai, Ai, Ai, Xu, Aa, Aa, Aa, Xu, Wo, Xu, Xu, Xu, Ww, Ww, Gd, Gd, Rr, Xu, Ql, Mv, Xu, Xu, Gd^Fdf, Xu, Rr, Rr, Cud, Rr, Rr, Wwf, Ww, Wwt, Wwt, Wwt, Ww, Wwf, Rr, Rr, Cud, Rr, Rr, Xu, Gd^Fdf, Xu, Xu, Mv, Ql, Xu, Rr, Gd, Gd, Ww, Ww, Xu, Xu, Xu, Wo, Xu, Aa, Aa, Aa, Xu, Ai, Ai, Ai
Ai, Ai, Ai, Xu, Aa, Xu, Aa, Xu, Wo, Wo, Xu, Xu, Wwf, Ww, Gd, Gd, Rr, Xu, Xu, Qxu, Xu, Gd^Fdf, Rr, Rp, Gd, Gd, Gd, Xu, Rr, Ds, Ds, Wwt, Wwt, Wwt, Ds, Ds, Rr, Xu, Gd, Gd, Gd, Rr, Rr, Gd^Fdf, Xu, Qxu, Xu, Xu, Rr, Gd, Gd, Ww, Wwf, Xu, Xu, Wo, Wo, Xu, Aa, Xu, Aa, Xu, Ai, Ai, Ai
Ai, Ai, Ai, Xu, Xu, Aa, Xu, Xu, Xu, Xu, Ai, Xu, Xu, Wwf, Rr, Rr, Gd, Rr, Rr, Xu, Rr, Rr, Xu, Xu, Xu, Hhd, Xu, Xu, Rr, Gs, Gd^Fdf, Ds, Xu, Ds, Gd^Fdf, Gs, Rr, Xu, Xu, Hhd, Xu, Xu, Xu, Rr, Rr, Xu, Rr, Rr, Gd, Rr, Rr, Wwf, Xu, Xu, Ai, Xu, Xu, Xu, Xu, Aa, Xu, Xu, Ai, Ai, Ai
Ai, Ai, Ai, Ai, Ai, Xu, Ai, Ai, Xu, Ai, Xu, Ai, Xu, Cud, Cud, Cud, Cud, Gd, Gd, Rr, Uu^Vu, Uu, Xu, Ql, Ql, Xu, Gd^Fdf, Hhd, Rr, Xu, Gd, Xu, Ql, Xu, Gd, Xu, Rr, Hhd, Gd^Fdf, Xu, Ql, Ql, Xu, Uu, Uu^Vu, Rr, Gd, Gd, Cud, Cud, Cud, Cud, Xu, Ai, Xu, Ai, Xu, Ai, Ai, Xu, Ai, Ai, Ai, Ai, Ai
Ai, Ai, Ai, Ai, Ai, Ai, Ai, Ai, Xu, Ai, Ai, Ai, Xu, Kud, Xu, Xu, Xu, Xu, Xu, Uu, Qxu, Qxu, Xu, Ql, Xu, Xu, Rb, Wwf, Xu, Rr, Xue, Xu, Xu, Xu, Xue, Rr, Xu, Wwf, Rb, Xu, Xu, Ql, Xu, Qxu, Qxu, Uu, Xu, Xu, Xu, Xu, Xu, Kud, Xu, Ai, Ai, Ai, Xu, Ai, Ai, Ai, Ai, Ai, Ai, Ai, Ai
Ai, Ai, Ai, Ai, Ai, Ai, Ai, Ai, Ai, Xu, Xu, Xu, Ai, Xu, Ww, Ww, Ww, Xu, Wo, Xu, Xu, Xu, Ww, Xu, Qxu, Qxu^Bs|, Ww, Wwf, Cud, Rr, Xu, Xu, Uu, Xu, Xue, Rr, Cud, Wwf, Ww, Qxu^Bs|, Qxu, Xu, Ww, Xu, Xu, Xu, Wo, Xu, Ww, Ww, Ww, Xu, Ai, Xu, Xu, Xu, Ai, Ai, Ai, Ai, Ai, Ai, Ai, Ai, Ai
Ai, Ai, Ai, Ai, Ai, Ai, Ai, Ai, Ai, Ai, Ai, Ai, Ai, Xu, Ww, Xu, Ww, Xu, Wo, Wo, Xu, Ww, Ww, Xu, Uu, Rb, Ww, Xu, Uh, Kud, Xu, Uu, Uu, Uu, Xu, Kud, Uh, Xu, Ww, Rb, Uu, Xu, Ww, Ww, Xu, Wo, Wo, Xu, Ww, Xu, Ww, Xu, Ai, Ai, Ai, Ai, Ai, Ai, Ai, Ai, Ai, Ai, Ai, Ai, Ai
Ai, Ai, Ai, Ai, Ai, Ai, Ai, Ai, Ai, Ai, Ai, Ai, Ai, Xu, Xu, Ww, Xu, Xu, Xu, Xu, Wo, Xu, Xu, Xu, Xu, Qxu, Xu, Ww, Xu, Xu, Ql, Xu, Xu, Xu, Ql, Xu, Xu, Ww, Xu, Qxu, Xu, Xu, Xu, Xu, Wo, Xu, Xu, Xu, Xu, Ww, Xu, Xu, Ai, Ai, Ai, Ai, Ai, Ai, Ai, Ai, Ai, Ai, Ai, Ai, Ai
Ai, Ai, Ai, Ai, Ai, Ai, Ai, Ai, Ai, Ai, Ai, Ai, Ai, Ai, Ai, Xu, Ai, Ai, Xu, Wo, Xu, Wo, Xu, Rd, Rd, Xu, Dd, Xu, Xu, Ql, Ql, Ql, Xu, Ql, Ql, Ql, Xu, Xu, Dd, Xu, Rd, Rd, Xu, Wo, Xu, Wo, Xu, Ai, Ai, Xu, Ai, Ai, Ai, Ai, Ai, Ai, Ai, Ai, Ai, Ai, Ai, Ai, Ai, Ai, Ai
Ai, Ai, Ai, Ai, Ai, Ai, Ai, Ai, Ai, Ai, Ai, Ai, Ai, Ai, Ai, Ai, Ai, Ai, Xu, Wo, Wo, Wo, Xu, Rd, Xu, Xu, Xu, Dd, Xu, Ql, Ql, Ql, Xu, Ql, Ql, Ql, Xu, Dd, Xu, Xu, Xu, Rd, Xu, Wo, Wo, Wo, Xu, Ai, Ai, Ai, Ai, Ai, Ai, Ai, Ai, Ai, Ai, Ai, Ai, Ai, Ai, Ai, Ai, Ai, Ai
Ai, Ai, Ai, Ai, Ai, Ai, Ai, Ai, Ai, Ai, Ai, Ai, Ai, Ai, Ai, Ai, Ai, Ai, Ai, Xu, Xu, Xu, Ai, Xu, Uu, Uu, Uu, Xu, Ds, Xu, Xu, Xu, Ds, Xu, Xu, Xu, Ds, Xu, Uu, Uu, Uu, Xu, Ai, Xu, Xu, Xu, Ai, Ai, Ai, Ai, Ai, Ai, Ai, Ai, Ai, Ai, Ai, Ai, Ai, Ai, Ai, Ai, Ai, Ai, Ai
Ai, Ai, Ai, Ai, Ai, Ai, Ai, Ai, Ai, Ai, Ai, Ai, Ai, Ai, Ai, Ai, Ai, Ai, Ai, Ai, Ai, Ai, Ai, Xu, Uu, Xu, Uu, Xu, Ds, Ds, Xu, Ds, Ds, Ds, Xu, Ds, Ds, Xu, Uu, Xu, Uu, Xu, Ai, Ai, Ai, Ai, Ai, Ai, Ai, Ai, Ai, Ai, Ai, Ai, Ai, Ai, Ai, Ai, Ai, Ai, Ai, Ai, Ai, Ai, Ai
Ai, Ai, Ai, Ai, Ai, Ai, Ai, Ai, Ai, Ai, Ai, Ai, Ai, Ai, Ai, Ai, Ai, Ai, Ai, Ai, Ai, Ai, Ai, Xu, Xu, Uu, Xu, Xu, Xu, Xu, Aa, Xu, Xu, Xu, Aa, Xu, Xu, Xu, Xu, Uu, Xu, Xu, Ai, Ai, Ai, Ai, Ai, Ai, Ai, Ai, Ai, Ai, Ai, Ai, Ai, Ai, Ai, Ai, Ai, Ai, Ai, Ai, Ai, Ai, Ai
Ai, Ai, Ai, Ai, Ai, Ai, Ai, Ai, Ai, Ai, Ai, Ai, Ai, Ai, Ai, Ai, Ai, Ai, Ai, Ai, Ai, Ai, Ai, Ai, Ai, Xu, Ai, Ai, Xu, Aa, Xu, Aa, Aa, Aa, Xu, Aa, Xu, Ai, Ai, Xu, Ai, Ai, Ai, Ai, Ai, Ai, Ai, Ai, Ai, Ai, Ai, Ai, Ai, Ai, Ai, Ai, Ai, Ai, Ai, Ai, Ai, Ai, Ai, Ai, Ai
Ai, Ai, Ai, Ai, Ai, Ai, Ai, Ai, Ai, Ai, Ai, Ai, Ai, Ai, Ai, Ai, Ai, Ai, Ai, Ai, Ai, Ai, Ai, Ai, Ai, Ai, Ai, Ai, Xu, Aa, Aa, Aa, Xu, Aa, Aa, Aa, Xu, Ai, Ai, Ai, Ai, Ai, Ai, Ai, Ai, Ai, Ai, Ai, Ai, Ai, Ai, Ai, Ai, Ai, Ai, Ai, Ai, Ai, Ai, Ai, Ai, Ai, Ai, Ai, Ai
Ai, Ai, Ai, Ai, Ai, Ai, Ai, Ai, Ai, Ai, Ai, Ai, Ai, Ai, Ai, Ai, Ai, Ai, Ai, Ai, Ai, Ai, Ai, Ai, Ai, Ai, Ai, Ai, Ai, Xu, Xu, Xu, Ai, Xu, Xu, Xu, Ai, Ai, Ai, Ai, Ai, Ai, Ai, Ai, Ai, Ai, Ai, Ai, Ai, Ai, Ai, Ai, Ai, Ai, Ai, Ai, Ai, Ai, Ai, Ai, Ai, Ai, Ai, Ai, Ai
Ai, Ai, Ai, Ai, Ai, Ai, Ai, Ai, Ai, Ai, Ai, Ai, Ai, Ai, Ai, Ai, Ai, Ai, Ai, Ai, Ai, Ai, Ai, Ai, Ai, Ai, Ai, Ai, Ai, Ai, Ai, Ai, Ai, Ai, Ai, Ai, Ai, Ai, Ai, Ai, Ai, Ai, Ai, Ai, Ai, Ai, Ai, Ai, Ai, Ai, Ai, Ai, Ai, Ai, Ai, Ai, Ai, Ai, Ai, Ai, Ai, Ai, Ai, Ai, Ai
Ai, Ai, Ai, Ai, Ai, Ai, Ai, Ai, Ai, Ai, Ai, Ai, Ai, Ai, Ai, Ai, Ai, Ai, Ai, Ai, Ai, Ai, Ai, Ai, Ai, Ai, Ai, Ai, Ai, Ai, Ai, Ai, Ai, Ai, Ai, Ai, Ai, Ai, Ai, Ai, Ai, Ai, Ai, Ai, Ai, Ai, Ai, Ai, Ai, Ai, Ai, Ai, Ai, Ai, Ai, Ai, Ai, Ai, Ai, Ai, Ai, Ai, Ai, Ai, Ai
Ai, Ai, Ai, Ai, Ai, Ai, Ai, Ai, Ai, Ai, Ai, Ai, Ai, Ai, Ai, Ai, Ai, Ai, Ai, Ai, Ai, Ai, Ai, Ai, Ai, Ai, Ai, Ai, Ai, Ai, Ai, Ai, Ai, Ai, Ai, Ai, Ai, Ai, Ai, Ai, Ai, Ai, Ai, Ai, Ai, Ai, Ai, Ai, Ai, Ai, Ai, Ai, Ai, Ai, Ai, Ai, Ai, Ai, Ai, Ai, Ai, Ai, Ai, Ai, Ai
